12 12 6
BBBBBBBBBBBB
BBBBBBBBBBBB
BBBBBBBBBBBB
BBBBBBBBBBBB
BBBBBBBBBBBB
BBBBBBBBBBBB
BBBBBBBBBBBB
BBBBBBBBBBBB
BBBBBBBBBBBB
BBBBBBBBBBBB
BBBBBBBBBBBB
BBBBBBBBBBBB

############
############
############
############
############
############
############
############
############
############
############
############

############
############
############
############
############
############
############
############
############
############
############
############

............
............
............
............
............
............
............
............
............
............
............
............

............
............
............
............
............
............
............
............
............
............
............
............

............
............
............
............
............
............
............
............
............
............
............
............

